111111
1C0001
100001
1E0001
10C001
101101
1P0001
100001
100001
100001
100C01
111111
